%%%%%%%%%%%%%%%%%%%%%
%    T      %     % %
%      %            %
% %   % %           %
%  %     % % %      %
%     %             %
%          %       %%
% %       %   % %   %
%% %   %   % %      %
%   %           %   %
%%   % %            %
%       % %         %
%    %   %       %  %
% %   %           % S
%  %   %   %   % %  %
%     %   %      K% %
%  %   %           G%
%   %   % %   %     %
%  %           % % %%
%   %   %           %
%%%%%%%%%%%%%%%%%%%%%
