%%%%%%%%%%%%%%%%%%%S%
%     %   %         %
%%         % % % %  %
%     %   %         %
%                   %
% % %   %   %   %   %
%  %                %
%            T    % %
%          % % % G %%
%   % %        K    %
%  % % % %   %   %  %
% %                 %
%                %  %
%       %           %
%    %   %         %%
% %   %             %
%%   %     %   %    %
%             % %   %
%    %   % %       %%
%     %     %       %
%%%%%%%%%%%%%%%%%%%%%