%%%%%%%%%%%%%%%%%%%%%
S %       %      %  %
%      %   %        %
%                   %
%  %     % % % %   %%
% %             %   %
%        %   %     %%
%      %        %   %
%       % % %  %    %
%               %   %
%  % %           %  %
%             %     %
%      %            %
%   %   % %T        %
%                  %%
%     % %   %   %   %
%  %               %%
%   % %         %   %
%        %         %%
% %                 %
%%%%%%%%%%%%%%%%%%%%%